Welcome to the City of Upstoki surroundings. you feel that is better that  you get inside soon, but you really don't know why...

UpstokiNew
When danger is coming by Geraldo
Release 3 / Serial number 121105 / Inform 7 build 6G60 (I6/v6.32 lib 6/12N) SD

Bridge of Upstoki
You are in the Bridge of Upstoki, in front of the Great Gate of the city of Upstoki, in front of you is the enourmous city of Upstoki, a legend of mistery, terror and wonders. Its walls are 30 meters high, and its towers are even higher. In the end of the Bridge there is the only know entrance to the city. South of it there is the Outside Market

You can see a Great Gate of the city of Upstoki and guard here.

>enter gate
(first opening the Great Gate of the city of Upstoki)
It seems to be locked.

[Your score has just gone up by fifteen points.]

>look guard
You see nothing special about guard.

>ask guard about gate
You need a pass to enter.

[Your score has just gone up by ten points.]

>ask guard about pass
You can ask Loriel for a pass.

[Your score has just gone up by ten points.]

>kill guard
You kill the guard with you bare hands and teeth... That was a bloody and messy death...

 The Great Gate opens and twenty young, strong and very upset guards run in your direction. They beat you. And then they beat you more and more. You faint....

 ...You  wake up, hours later, in damp and small prison cell. You notice that you don't have a door in the cell. You've been buried alive in the infamous dungeons of Upstoki.

    *** You have died ***

In that game you scored 35 out of a possible 100, in 5 turns.

Would you like to RESTART, RESTORE a saved game, QUIT or UNDO the last command?

* * *

>enter gate
(first opening the Great Gate of the city of Upstoki)
It seems to be locked.

[Your score has just gone up by fifteen points.]

>ask guard about gate
You need a pass to enter.

[Your score has just gone up by ten points.]

* * *

>ask guard about pass
You can ask Loriel for a pass.

[Your score has just gone up by ten points.]

>ask guard about loriel
You can find Loriel in the Pass Tent, on the Outside Market
[Your score has just gone up by ten points.]

>look
Bridge of Upstoki
You are in the Bridge of Upstoki, in front of the Great Gate of the city of Upstoki, in front of you is the enourmous city of Upstoki, a legend of mistery, terror and wonders. Its walls are 30 meters high, and its towers are even higher. In the end of the Bridge there is the only know entrance to the city. South of it there is the Outside Market

You can see a Great Gate of the city of Upstoki and guard here.

>s
Outer Market
A typical but very small market, with shabby tents.  At South there is beautiful and shiny tent with a sign:  Passes for the city

>s
Pass Tent
The tent is large. There are some shelves and books. At the end of the tent is a desk with a old  man sitted behind it. There is a sign in the table reading "Pass: $12". There is a pile of passes on the table

On Desk is Pass ($12).

You can also see Loriel here.

>ask loriel about pass
There is no reply.

>buy pass
You hand Loriel two copper yobes and a silver yobe. "Here ya go," says Loriel, handing Pass to you. Your transaction is now complete, leaving you with $132.

>n
Outer Market
A typical but very small market, with shabby tents.  At South there is beautiful and shiny tent with a sign:  Passes for the city

>n
Bridge of Upstoki
You are in the Bridge of Upstoki, in front of the Great Gate of the city of Upstoki, in front of you is the enourmous city of Upstoki, a legend of mistery, terror and wonders. Its walls are 30 meters high, and its towers are even higher. In the end of the Bridge there is the only know entrance to the city. South of it there is the Outside Market

You can see a Great Gate of the city of Upstoki and guard here.

>give pass to guard
The guard picks the pass and carefully examine it. Giving a satisfying nod, he unlocks and opens the gate with the key and bows for you to go. He also keeps the pass
[Your score has just gone up by thirty points.]

>enter gate
Entrance of the city of Upstoki
You can see a Great Gate of the city of Upstoki here.

* * *

>kiss the guard
Go away

* * *

>ask guard about enter
You need a pass to enter.

[Your score has just gone up by ten points.]

>ask guard about enter
Bug off, I've told you to get a pass
[Your score has just gone down by one point.]

>ask guard about enter
Bug off, I've told you to get a pass
[Your score has just gone down by one point.]

* * *

>i
You are carrying:
  a golden yobe, four silver yobes and four copper yobes

Altogether, you've got $144 on your person

>say hi to guard
There is no reply.

>n
(first opening the Great Gate of the city of Upstoki)
It seems to be locked.

[Your score has just gone up by fifteen points.]

>look
Bridge of Upstoki
You are in the Bridge of Upstoki, in front of the Great Gate of the city of Upstoki, in front of you is the enourmous city of Upstoki, a legend of mistery, terror and wonders. Its walls are 30 meters high, and its towers are even higher. In the end of the Bridge there is the only know entrance to the city. South of it there is the Outside Market

You can see a Great Gate of the city of Upstoki and guard here.

>ask guard about gate
You need a pass to enter.

[Your score has just gone up by ten points.]

* * *

>ask guard about loriel
You can find Loriel in the Pass Tent, on the Outside Market
[Your score has just gone up by ten points.]

>ask guard about market
There is no reply.

>s
Outer Market
A typical but very small market, with shabby tents.  At South there is beautiful and shiny tent with a sign:  Passes for the city

>look
Outer Market
A typical but very small market, with shabby tents.  At South there is beautiful and shiny tent with a sign:  Passes for the city

>s
Pass Tent
The tent is large. There are some shelves and books. At the end of the tent is a desk with a old  man sitted behind it. There is a sign in the table reading "Pass: $12". There is a pile of passes on the table

On Desk is Pass ($12).

You can also see Loriel here.

>buy pass
You hand Loriel two copper yobes and a silver yobe. "Here ya go," says Loriel, handing Pass to you. Your transaction is now complete, leaving you with $132.

* * *

>n
Bridge of Upstoki
You are in the Bridge of Upstoki, in front of the Great Gate of the city of Upstoki, in front of you is the enourmous city of Upstoki, a legend of mistery, terror and wonders. Its walls are 30 meters high, and its towers are even higher. In the end of the Bridge there is the only know entrance to the city. South of it there is the Outside Market

You can see a Great Gate of the city of Upstoki and guard here.

>i
You are carrying:
  Pass
  a golden yobe, three silver yobes and two copper yobes

Altogether, you've got $132 on your person

>give pass to guard
The guard picks the pass and carefully examine it. Giving a satisfying nod, he unlocks and opens the gate with the key and bows for you to go. He also keeps the pass
[Your score has just gone up by thirty points.]

>i
You are carrying:
  a golden yobe, three silver yobes and two copper yobes

Altogether, you've got $132 on your person

>restart
Are you sure you want to restart?

* * *

>i
You are carrying:
  a golden yobe, three silver yobes and two copper yobes

Altogether, you've got $132 on your person

I beg your pardon?

>n
Entrance of the city of Upstoki
You can see a Great Gate of the city of Upstoki here.

You just feel a shiver

* * *

>kiss guard
Keep your mind on the game.

* * *

>s
Outer Market
A typical but very small market, with shabby tents.  At South there is beautiful and shiny tent with a sign:  Passes for the city

* * *

>buy pass
You hand Loriel two copper yobes and a silver yobe. "Here ya go," says Loriel, handing Pass to you. Your transaction is now complete, leaving you with $132.

>buy pass
You already own Pass.

* * *

>buy pass
You hand Loriel two copper yobes and a silver yobe. "Here ya go," says Loriel, handing Pass to you. Your transaction is now complete, leaving you with $132.

>get pass
"You can look at it, but you can't leave without paying
Taken.

>out
"Hey there buddy, not so fast," says Loriel. "You going to buy Pass first, or am I gonna call the cops?"

>out
"Hey there buddy, not so fast," says Loriel. "You going to buy Pass first, or am I gonna call the cops?"

>out
"Hey there buddy, not so fast," says Loriel. "You going to buy Pass first, or am I gonna call the cops?"
You bastard! Guards! Guards!

>[enter]
The guards arrive, they are many, and they are strong... You try to escape, but fail... You are beaten and arrested. They don't like thieves in the town...

>[enter]
It seems that they have a very harsh law in the city: death for any foreigner that commits a crime!

    *** You have died ***

In that game you scored 0 out of a possible 100, in 7 turns.

Would you like to RESTART, RESTORE a saved game, QUIT or UNDO the last command?

>restart
Welcome to the City of Upstoki surroundings. you feel that is better that  you get inside soon, but you really don't know why...

UpstokiNew
When danger is coming by Geraldo
Release 3 / Serial number 110429 / Inform 7 build 6G60 (I6/v6.32 lib 6/12N) SD

Bridge of Upstoki
You are in the Bridge of Upstoki, in front of the Great Gate of the city of Upstoki, in front of you is the enourmous city of Upstoki, a legend of mistery, terror and wonders. Its walls are 30 meters high, and its towers are even higher. In the end of the Bridge there is the only know entrance to the city. South of it there is the Outside Market

You can see a Great Gate of the city of Upstoki and guard here.

>s
Outer Market
A typical but very small market, with shabby tents.  At South there is beautiful and shiny tent with a sign:  Passes for the city

* * *

>s
Pass Tent
The tent is large. There are some shelves and books. At the end of the tent is a desk with a old  man sitted behind it. There is a sign in the table reading "Pass: $12". There is a pile of passes on the table

On Desk is Pass ($12).

You can also see Loriel here.

>buy pass
Nothing is on sale.

* * *

>i
You are carrying:
  a golden yobe, three silver yobes and two copper yobes

Altogether, you've got $132 on your person

>ex guard
That's not a verb I recognise.

>x guard
You see nothing special about guard.

>examine guard
You see nothing special about guard.

* * *

>s
Pass Tent
The tent is large. There are some shelves and books. At the end of the tent is a desk with a old  man sitted behind it. There is a sign in the table reading "Pass: $12". There is a pile of passes on the table

On Desk is Pass ($12).

You can also see Loriel here.

>s
You can't go that way.

>buy
What do you want to buy?

>pass
Nothing is on sale.

>examine pass
A paper pass, with a winged crinson dragon with a spear on it and saying "The holder of this pass allowed to enter Upstoki, but there is no guarantee that he or she (or it) will be allowed or able to leave the city"

Pass costs $12, payable to Loriel.

* * *

>open gate
It seems to be locked.

[Your score has just gone up by fifteen points.]

>unlock gate
What do you want to unlock the Great Gate of the city of Upstoki with?

>ask guard about gate
You need a pass to enter.

[Your score has just gone up by ten points.]

* * *

>ask guard about pass
You can ask Loriel for a pass.

[Your score has just gone up by ten points.]

>ask guard about Loriel
You can find Loriel in the Pass Tent, on the Outside Market
[Your score has just gone up by ten points.]

>s
Outer Market
A typical but very small market, with shabby tents.  At South there is beautiful and shiny tent with a sign:  Passes for the city

* * *

>s
Pass Tent
The tent is large. There are some shelves and books. At the end of the tent is a desk with a old  man sitted behind it. There is a sign in the table reading "Pass: $12". There is a pile of passes on the table

On Desk is Pass ($12).

You can also see Loriel here.

>get pass
"You can look at it, but you can't leave without paying
Taken.

* * *

>out
"Hey there buddy, not so fast," says Loriel. "You going to buy Pass first, or am I gonna call the cops?"
You bastard! Guards! Guards!

 The guards arrive, they are many, and they are strong... You try to escape, but fail... You are beaten and arrested. They don't like thieves in the town...

 It seems that they have a very harsh law in the city: death for any foreigner that commits a crime!

    *** You have died ***

In that game you scored 45 out of a possible 100, in 10 turns.

Would you like to RESTART, RESTORE a saved game, QUIT or UNDO the last command?