Welcome to the City of Upstoki surroundings. you feel that is better that  you get inside soon, but you really don't know why...

The City of Upstoki
When danger is coming by Geraldo Xexéo
Release 6 / Serial number 190726 / Inform 7 build 6M62 (I6/v6.33 lib 6/12N) SD

Bridge of Upstoki
You are in the Bridge of Upstoki, in front of the Great Gate of the city of Upstoki, in front of you is the enourmous city of Upstoki, a legend of mistery, terror and wonders. Its walls are 30 meters high, and its towers are even higher. In the end of the Bridge there is the only know entrance to the city. South of it there is the Outside Market

The Guard seems to be very worried. 

You can also see a Great Gate of the city of Upstoki here.

>RULES
Rules tracing now switched on. Type "rules off" to switch it off again, or "rules all" to include even rules which do not apply.

* * *

>look
Bridge of Upstoki
You are in the Bridge of Upstoki, in front of the Great Gate of the city of Upstoki, in front of you is the enourmous city of Upstoki, a legend of mistery, terror and wonders. Its walls are 30 meters high, and its towers are even higher. In the end of the Bridge there is the only know entrance to the city. South of it there is the Outside Market

The Guard seems to be very worried. 

You can also see a Great Gate of the city of Upstoki here.

I beg your pardon?

>look
Bridge of Upstoki
You are in the Bridge of Upstoki, in front of the Great Gate of the city of Upstoki, in front of you is the enourmous city of Upstoki, a legend of mistery, terror and wonders. Its walls are 30 meters high, and its towers are even higher. In the end of the Bridge there is the only know entrance to the city. South of it there is the Outside Market

The Guard seems to be very worried. 

You can also see a Great Gate of the city of Upstoki here.

>x guard
You look at the guard more closely and he announces "I am Walstron, Lesser Guard of the Great Gate!"
Guard Walstron is openly carrying a golden key and a spear.

>ask guard about key
This golden key opens the gate. It was trusted to me by the Great Keeper of The Great Gate!

>ask guard about gate
You need a pass to enter.

[Your score has just gone up by ten points.]

>ask guard about pass
You can ask Loriel for a pass.

[Your score has just gone up by ten points.]

>ask guard about loriel
You can find Loriel in the Pass Tent, on the Outside Market
[Your score has just gone up by ten points.]

>ask guard about market
There is no reply.

* * *

>look
Bridge of Upstoki
You are in the Bridge of Upstoki, in front of the Great Gate of the city of Upstoki, in front of you is the enourmous city of Upstoki, a legend of mistery, terror and wonders. Its walls are 30 meters high, and its towers are even higher. In the end of the Bridge there is the only know entrance to the city. South of it there is the Outside Market

The Guard seems to be very worried. 

You can also see a Great Gate of the city of Upstoki here.

>examine
What do you want to examine?

>examine bridge
You can't see any such thing.

>examine room
You can't see any such thing.

* * *

>look
Bridge of Upstoki
You are in the Bridge of Upstoki, in front of the Great Gate of the city of Upstoki, in front of you is the enourmous city of Upstoki, a legend of mistery, terror and wonders. Its walls are 30 meters high, and its towers are even higher. In the end of the Bridge there is the only know entrance to the city. South of it there is the Outside Market

The Guard seems to be very worried. 

You can also see a Great Gate of the city of Upstoki here.

>look guard
You see nothing special about guard.

>look guard
You see nothing special about guard.

>look at guard
You see nothing special about guard.

>enter
You must supply a noun.

>enter city
(first opening the Great Gate of the city of Upstoki)
It seems to be locked.

[Your score has just gone up by fifteen points.]

>open Gate
It seems to be locked.

[Your score has just gone up by fifteen points.]

>unlock gate
What do you want to unlock the Great Gate of the city of Upstoki with?

>ask guard about gate
You need a pass to enter.

[Your score has just gone up by ten points.]

* * *

>ask guard about pass
You can ask Loriel for a pass.

[Your score has just gone up by ten points.]

>ask guard about Loriel
You can find Loriel in the Pass Tent, on the Outside Market
[Your score has just gone up by ten points.]

>map
That's not a verb I recognise.

>s
Outer Market
A typical but very small market, with shabby tents.  At South there is beautiful and shiny tent with a sign:  Passes for the city

>s
Pass Tent
The tent is large. There are some shelves and books. At the end of the tent is a desk with a old  man sitted behind it. There is a sign in the table reading "Pass: $12". There is a pile of passes on the table

On Desk is Pass ($12).

You can also see Loriel here.

>buy pass
You hand Loriel a silver yobe. Loriel makes change with two copper yobes. "Here ya go," says Loriel, handing Pass to you. Your transaction is now complete, leaving you with $136.

>n
You try to leave with copper yobe 

you sneaky bastard 

Outer Market
A typical but very small market, with shabby tents.  At South there is beautiful and shiny tent with a sign:  Passes for the city

>i
You are carrying:
  Pass
  six copper yobes, a golden yobe and three silver yobes

Altogether, you've got $136 on your person

>showme Table of Stolen Things
There seems to be no such object anywhere in the model world.

* * *

>n
You try to leave with copper yobe 

you sneaky bastard 

Outer Market
A typical but very small market, with shabby tents.  At South there is beautiful and shiny tent with a sign:  Passes for the city

>s
You try to leave with copper yobe 

you sneaky bastard 

Pass Tent
The tent is large. There are some shelves and books. At the end of the tent is a desk with a old  man sitted behind it. There is a sign in the table reading "Pass: $12". There is a pile of passes on the table

You can see Loriel here.

>restart
Are you sure you want to restart?

>y
Welcome to the City of Upstoki surroundings. you feel that is better that  you get inside soon, but you really don't know why...

The City of Upstoki
When danger is coming by Geraldo Xexéo
Release 3 / Serial number 161011 / Inform 7 build 6M62 (I6/v6.33 lib 6/12N) SD

Bridge of Upstoki
You are in the Bridge of Upstoki, in front of the Great Gate of the city of Upstoki, in front of you is the enourmous city of Upstoki, a legend of mistery, terror and wonders. Its walls are 30 meters high, and its towers are even higher. In the end of the Bridge there is the only know entrance to the city. South of it there is the Outside Market

You can see a Great Gate of the city of Upstoki and guard here.

* * *

>buy pass
You hand Loriel a silver yobe. Loriel makes change with two copper yobes. "Here ya go," says Loriel, handing Pass to you. Your transaction is now complete, leaving you with $136.

>show me cashbox
You can't see any such thing.

>showme cashbox
cashbox - open container
    100 golden coins
    1000 silver coins
    10000 copper coins
location: out of play
singular-named, improper-named; unlit, inedible, portable; opaque, open, unopenable, unlocked
list grouping key: none
printed name: "cashbox"
printed plural name: "containers"
indefinite article: none
description: none
initial appearance: none
price: $0
carrying capacity: 100

>showme sum in the cashbox
There seems to be no such object anywhere in the model world.

>i
You are carrying:
  four silver yobes, a golden yobe and four copper yobes

Altogether, you've got $144 on your person

* * *

>buy pass
You hand Loriel a silver yobe. Loriel makes change with two copper yobes. "Here ya go," says Loriel, handing Pass to you. Your transaction is now complete, leaving you with $136.

>showme cashbox
cashbox - open container
    100 golden coins
    1000 silver coins
    10000 copper coins
location: out of play
singular-named, improper-named; unlit, inedible, portable; opaque, open, unopenable, unlocked
list grouping key: none
printed name: "cashbox"
printed plural name: "containers"
indefinite article: none
description: none
initial appearance: none
price: $0
carrying capacity: 100

>what price in cashbox
That's not a verb I recognise.

* * *

>s
Pass Tent
The tent is large. There are some shelves and books. At the end of the tent is a desk with a old  man sitted behind it. There is a sign in the table reading "Pass: $12". There is a pile of passes on the table

On Desk is Pass ($12).

You can also see Loriel here.

>get pass
"You can look at it, but you can't leave without paying
Taken.

>n
You try to leave with Pass 

you sneaky bastard 

"Hey there buddy, not so fast," says Loriel. "You going to buy Pass first, or am I gonna call the cops?"

>look
Pass Tent
The tent is large. There are some shelves and books. At the end of the tent is a desk with a old  man sitted behind it. There is a sign in the table reading "Pass: $12". There is a pile of passes on the table

You can see Loriel here.

>buy pass
You hand Loriel a silver yobe. Loriel makes change with two copper yobes. Your transaction is now complete, leaving you with $136.

>n
You try to leave with copper yobe 

you sneaky bastard 

Outer Market
A typical but very small market, with shabby tents.  At South there is beautiful and shiny tent with a sign:  Passes for the city

>look
Outer Market
A typical but very small market, with shabby tents.  At South there is beautiful and shiny tent with a sign:  Passes for the city

>i
You are carrying:
  Pass
  six copper yobes, a golden yobe and three silver yobes

Altogether, you've got $136 on your person

>n
You try to leave with copper yobe 

you sneaky bastard 

Bridge of Upstoki
You are in the Bridge of Upstoki, in front of the Great Gate of the city of Upstoki, in front of you is the enourmous city of Upstoki, a legend of mistery, terror and wonders. Its walls are 30 meters high, and its towers are even higher. In the end of the Bridge there is the only know entrance to the city. South of it there is the Outside Market

You can see a Great Gate of the city of Upstoki and guard here.

>give pass to guard
The guard picks the pass and carefully examine it. Giving a satisfying nod, he unlocks and opens the gate with the key and bows for you to pass.

[Your score has just gone up by thirty points.]

>n
Entrance of the city of Upstoki
You enter the magnificent City of Upstoki for the first time. It is beautiful, but troubled! You arrive at a large plaza. Guards run in all drections. The population, carrying sacs and cases, run north, following a large street that ends in a door in the mountain far away.

You can see a Great Gate of the city of Upstoki here.

>enter gate
Bridge of Upstoki
You are in the Bridge of Upstoki, in front of the Great Gate of the city of Upstoki, in front of you is the enourmous city of Upstoki, a legend of mistery, terror and wonders. Its walls are 30 meters high, and its towers are even higher. In the end of the Bridge there is the only know entrance to the city. South of it there is the Outside Market

You can see a Great Gate of the city of Upstoki and guard here.

>enter gate
Entrance of the city of Upstoki
 You arrive at a large plaza. Guards run in all drections. The population, carrying sacs and cases, run north, following a large street that ends in a door in the mountain far away.

You can see a Great Gate of the city of Upstoki here.

>look
Entrance of the city of Upstoki
 You arrive at a large plaza. Guards run in all drections. The population, carrying sacs and cases, run north, following a large street that ends in a door in the mountain far away.

You can see a Great Gate of the city of Upstoki here.

>examine gate
You are in front of the Great Gate of the city of Upstoki. It is beautiful and terrifying, 20  meters tall, made of iron, with a great circle in the middle with the symbol of the city: a winged crinsom dragon armed with a spear.

>look
Entrance of the city of Upstoki
 You arrive at a large plaza. Guards run in all drections. The population, carrying sacs and cases, run north, following a large street that ends in a door in the mountain far away.

You can see a Great Gate of the city of Upstoki here.

>restart
Are you sure you want to restart?

* * *

>s
Outer Market
A typical but very small market, with shabby tents.  At South there is beautiful and shiny tent with a sign:  Passes for the city

* * *

>n
You try to leave with copper yobe 

you sneaky bastard 

Outer Market
A typical but very small market, with shabby tents.  At South there is beautiful and shiny tent with a sign:  Passes for the city

>n
You try to leave with copper yobe 

you sneaky bastard 

Bridge of Upstoki
You are in the Bridge of Upstoki, in front of the Great Gate of the city of Upstoki, in front of you is the enourmous city of Upstoki, a legend of mistery, terror and wonders. Its walls are 30 meters high, and its towers are even higher. In the end of the Bridge there is the only know entrance to the city. South of it there is the Outside Market

You can see a Great Gate of the city of Upstoki and guard here.

* * *

>give pass to guard
The guard picks the pass and carefully examine it. Giving a satisfying nod, he unlocks and opens the gate with the key and bows for you to pass.

[Your score has just gone up by thirty points.]

>n
After you enter the city, you see Loriel and some guards entering the city after ou. A platoon runs to the gate, closes and locks it. They also block it, and you noticed that it will be very difficult to leave the city for the following days.

Entrance of the city of Upstoki
You enter the magnificent City of Upstoki for the first time. It is beautiful, but troubled! You arrive at a large plaza. Guards run in all drections. The population, carrying sacs and cases, run north, following a large street that ends in a door in the mountain far away.

You can see Loriel and a Great Gate of the city of Upstoki here.

>exemine City
That's not a verb I recognise.

>examine entrance
You can't see any such thing.

>examine Entrance
You can't see any such thing.

>examine
What do you want to examine?

>look
Entrance of the city of Upstoki
You can see a Great Gate of the city of Upstoki here.

* * *

>look
Entrance of the city of Upstoki
 You arrive at a large plaza. Guards run in all drections. The population, carrying sacs and cases, run north, following a large street that ends in a door in the mountain far away.

You can see Loriel and a Great Gate of the city of Upstoki here.

>look
Entrance of the city of Upstoki
You arrive at a large plaza. Guards run in all drections. The population, carrying sacs and cases, run north, following a large street that ends in a door in the mountain far away.

You can see Loriel and a Great Gate of the city of Upstoki here.

>s
(first opening the Great Gate of the city of Upstoki)
It seems to be locked.

[Your score has just gone up by fifteen points.]

* * *

>s
Pass Tent
The tent is large. There are some shelves and books. At the end of the tent is a desk with a old  man sitted behind it. There is a sign in the table reading "Pass: $12". There is a pile of passes on the table

On Desk is Pass ($12).

You can also see Loriel here.

>n
Outer Market
A typical but very small market, with shabby tents.  At South there is beautiful and shiny tent with a sign:  Passes for the city

>s
Pass Tent
The tent is large. There are some shelves and books. At the end of the tent is a desk with a old  man sitted behind it. There is a sign in the table reading "Pass: $12". There is a pile of passes on the table

On Desk is Pass ($12).

You can also see Loriel here.

>get all
Pass: "You can look at it, but you can't leave without paying
Taken.

>i
You are carrying:
  Pass
  a golden yobe, four silver yobes and four copper yobes

Altogether, you've got $144 on your person

* * *

>look
Bridge of Upstoki
You are in the Bridge of Upstoki, in front of the Great Gate of the city of Upstoki, in front of you is the enourmous city of Upstoki, a legend of mistery, terror and wonders. Its walls are 30 meters high, and its towers are even higher. In the end of the Bridge there is the only know entrance to the city. South of it there is the Outside Market

The Guard seems to be very worried. 

You can also see a Great Gate of the city of Upstoki here.

>open gate
It seems to be locked.

[Your score has just gone up by fifteen points.]

>unlock game
You can't see any such thing.

>unlock gate
What do you want to unlock the Great Gate of the city of Upstoki with?

>i
You are carrying:
  a golden yobe, four silver yobes and four copper yobes

Altogether, you've got $144 on your person

>ask guard about gate
You need a pass to enter.

[Your score has just gone up by ten points.]

* * *

>ask guard about loriel
You can find Loriel in the Pass Tent, on the Outside Market
[Your score has just gone up by ten points.]

>s
Outer Market
A typical but very small market, with shabby tents.  At South there is beautiful and shiny tent with a sign:  Passes for the city

>i
You are carrying:
  a golden yobe, four silver yobes and four copper yobes

Altogether, you've got $144 on your person

>s
Pass Tent
The tent is large. There are some shelves and books. At the end of the tent is a desk with a old  man sitted behind it. There is a sign in the table reading "Pass: $12". There is a pile of passes on the table

On Desk is Pass ($12).

You can also see Loriel here.

* * *

>look
Pass Tent
The tent is large. There are some shelves and books. At the end of the tent is a desk with a old  man sitted behind it. There is a sign in the table reading "Pass: $12". There is a pile of passes on the table

You can see Loriel here.

>n
You try to leave with Pass 

"Hey there buddy, not so fast," says Loriel. "You going to buy Pass first, or am I gonna call the cops?"

>n
You try to leave with Pass 

"Hey there buddy, not so fast," says Loriel. "You going to buy Pass first, or am I gonna call the cops?"
You bastard! Guards! Guards!

>[enter]
The guards arrive, they are many, and they are strong... You try to escape, but fail... You are beaten and arrested. They don't like thieves in the town...

>[enter]
It seems that they have a very harsh law in the city: death for any foreigner that commits a crime!
You are taken to the executioner, who is an old friend of you, but kills you anyway

    *** You are dead ***

In that game you scored 45 out of a possible 100, in 14 turns.

Would you like to RESTART, RESTORE a saved game, QUIT or UNDO the last command?

>restart
Welcome to the City of Upstoki surroundings. you feel that is better that  you get inside soon, but you really don't know why...

The City of Upstoki
When danger is coming by Geraldo Xexéo
Release 3 / Serial number 161011 / Inform 7 build 6M62 (I6/v6.33 lib 6/12N) SD

Bridge of Upstoki
You are in the Bridge of Upstoki, in front of the Great Gate of the city of Upstoki, in front of you is the enourmous city of Upstoki, a legend of mistery, terror and wonders. Its walls are 30 meters high, and its towers are even higher. In the end of the Bridge there is the only know entrance to the city. South of it there is the Outside Market

You can see a Great Gate of the city of Upstoki and guard here.

* * *

>look
Bridge of Upstoki
You are in the Bridge of Upstoki, in front of the Great Gate of the city of Upstoki, in front of you is the enourmous city of Upstoki, a legend of mistery, terror and wonders. Its walls are 30 meters high, and its towers are even higher. In the end of the Bridge there is the only know entrance to the city. South of it there is the Outside Market

The Guard seems to be very worried. 

You can also see a Great Gate of the city of Upstoki here.

>x Guard
You look at the guard more closely and he announces "I am Walstron, Lesser Guard of the Great Gate!"
Guard Walstron is openly carrying a golden key and a spear.

>ask guard about gate
You need a pass to enter.

[Your score has just gone up by ten points.]

>ask guard about key
This golden key opens the gate. It was trusted to me by the Great Keeper of The Great Gate!

>ask guard about key
This key is trusted to me, I would not sell it even for 9 silver yobes!

>buy key
You hand Guard Walstron a golden yobe. "Here ya go," says Guard Walstron, handing the golden key to you. Your transaction is now complete, leaving you with $44.